7 11
###########
#S..#....T#
#.#.#.##..#
#.#M..#...#
#...#..M.L#
#..#L.#...#
###########
