6 9
#########
#S..#..T#
#.#.#.#.#
#.#M..#.#
#...#...#
#########
